################################################################
#                                                              #
#                                                              #
#                                                              #
#                                                              #
#                                                              #
#                                                              #
#                                                              #
#                                                              #
#                                                              #
#                                                              #
#                                                              #
#                                                              #
#                                                              #
#                                                              #
# ####   ###   ###   ###                                       #
# #   # #   # #     #                                          #
# ####  #   #  ###   ###                                       #
# #   # #   #     #     #                                      #
# ####   ###   ###   ###                                       #
#                                                              #
#                                                              #
#                                                              #
#                                                              #
#                                                              #
#                                                              #
#                                                              #
#                                                              #
#                                                              #
#                                                              #
#                                                              #
#                                                              #
#                                                              #
#                                                              #
#           ##### #   #  #  #####         #                    #
#           #      # #   #    #            #    # #            #
#           ###     #    #    #       #######                  #
#           #      # #   #    #            #    # #            #
#           ##### #   #  #    #           #                    #
#                                                              #
#                                                              #
#                                                              #
#                                                              #
################################################################
