################################################################
#                                                              #
#                                  #####       ###             #
#                    ########### ###   ##  # ### ##            #
#                  ###     ## ######    ######    ####         #
#                 ##            ##                   ##        #
#                ##                                   ###      #
#                #                                      ##     #
#     ###   ### ##                        x              ###   #
#    ## ##### ## ##                                        #   #
#   ##   ##    #####          #L                           #   #
#  ##            ###      #  #   #L                       ##   #
#  #                     #  ##  #                        ##    #
#  #                     # ##  #   ##                   ##     #
# ##                     # ## ## ##            x        #      #
# ##                      # ### ##                      #      #
# #                       #######                       #      #
# #                       ########                      #      #
# #                     ##############                  #      #
# ##                  ##################               ##      #
####                 ###BB#########553###             ##       #
##                  ###   BB######   BB###            #        #
##                  ###      SSS   ##BB###            #        #
##                  ### 444###S##  #######            #        #
##                  #########  ##########             #        #
##                   #######5  B#########            ##        #
##                    ######5  BB#######              ##       #
##      x              ######S#########                #       #
##                     ######S#########                ##      #
##                      ##x## ## ##x##                  ###    #
####                    ## ## ## ## ##                    ##   #
#  ## #                                                    ##  #
#  #####                 ## ##  ## ##                       #  #
#     ####               ##x## X##x##                       #  #
#        ###            ##############                     ##  #
#         #              ############                   ####   #
#         #                               x            ##      #
#         ##                                           #       #
#          ##                                         ##       #
#           ####                                     ##        #
#              ##                          #        ##         #
#               #####          ###       #####     ##          #
#                   ###  ##############L##   ##L####           #
################################################################
