################################################################
#                                                              #
#                                                              #
#                                                              #
#                                                              #
#                                                              #
#                                                              #
#                                                              #
#                                                              #
#                                                              #
#                             #                                #
#                         #  #   #                             #
#                        #  ##  #                              #
#                        # ##  #   ##                          #
#                        # ## ## ##                            #
#                         # ### ##                             #
#                         #######                              #
#                         ########                             #
#                       ##############                         #
#                     ##################                       #
#                    ###  #########553###                      #
#                   ###     ######     ###                     #
#                   ###      SSS   ##  ###                     #
#                   ### 444###S##  #######                     #
#                   #########  ##########                      #
#                    #######    #########            ##        #
#                     ######     #######              ##       #
##                     ######S#########                #       #
##                     ######S#########                ##      #
##                      ## ## ## ## ##                  ###    #
# ##                    ## ## ## ## ##                    ##   #
#  ## #                                                    ##  #
#  #####                 ## ##  ## ##                       #  #
#     ####               ## ##  ## ##                       #  #
#        ###            ##############                     ##  #
#         #              ############                   ####   #
#         #                                            ##      #
#         ##                                           #       #
#          ##                                         ##       #
#           ####                                     ##        #
#              ##                          #        ##         #
#               #####          ###       #####     ##          #
#                   ###  ############## ##   ## ####           #
################################################################
