################################################################
#                                                              #
#                                  #####       ###             #
#                    ########### ###   ##  # ### ##            #
#                  ###     ## ######    ######    ####         #
#                 ##            ##                   ##        #
#                ##                                   ###      #
#                #                                      ##     #
#     ###   ### ##                        x              ###   #
#    ## ##### ## ##                                        #   #
#   ##   ##    #####          #                            #   #
#  ##            ###      #  #   #                        ##   #
#  #                     #  ##  #                        ##    #
#  #                     # ##  #   ##                   ##     #
# ##                     # ## ## ##            x        #      #
# ##                      # ### ##                      #      #
# #                       #######                       #      #
# #                       ########                      #      #
# #                     ##############                  #      #
# ##                  ##################               ##      #
####                 ###  #########553###             ##       #
##                  ###     ######     ###            #        #
##                  ###      SSS   ##  ###            #        #
##                  ### 444###S##  #######            #        #
##                  #########  ##########             #        #
##                   #######    #########            ##        #
##                    ######     #######              ##       #
##      x              ######S#########                #       #
##                     ######S#########                ##      #
##                      ##x##x##x##x##                  ###    #
####                    ## ## ## ## ##                    ##   #
#  ## #                                                    ##  #
#  #####                 ## ##  ## ##                       #  #
#     ####               ##x##XX##x##                       #  #
#        ###            ##############                     ##  #
#         #              ############                   ####   #
#         #                               x            ##      #
#         ##                                           #       #
#          ##                                         ##       #
#           ####                                     ##        #
#              ##                          #        ##         #
#               #####          ###       #####     ##          #
#                   ###  ############## ##   ## ####           #
################################################################
