################################################################
#                                                              #
#                                                              #
#                                                              #
#                                                              #
#                                                              #
#                                                              #
#                                                              #
#                                                              #
#                                                              #
#                                                              #
#                                                              #
#                                                              #
#                                                              #
#                                                              #
#  ###   #   #   # ##### ####   #   #  ###                     #
# #     # #  #   # #     #   #  ##  # #                        #
# #     ###  #   # ###   ####   # # #  ###                     #
# #    #   #  # #  #     #  #   #  ##     #                    #
#  ### #   #   #   ##### #   #  #   #  ###                     #
#                                                              #
#                                                              #
#                                                              #
#                                                              #
#                                                              #
#                                                              #
#                                                              #
#                                                              #
#                                                              #
#                                                              #
#                                                              #
#                                                              #
#                                                              #
#                                                              #
#           ##### #   #  #  #####         #                    #
#           #      # #   #    #            #    # #            #
#           ###     #    #    #       #######                  #
#           #      # #   #    #            #    # #            #
#           ##### #   #  #    #           #                    #
#                                                              #
#                                                              #
#                                                              #
#                                                              #
################################################################
