################################################################
################################################################
################################################################
#############################      #############     &##########
##################BB########          ########       &&#########
###############   &   #### WWW              WW    L L  3########
##############  &     WWWWWWW     x        WWW         2########
############# &  ##S##WWWWW          x      WWW        #########
########22##&  ###SSS### WW                   WW ###############
#######Bxx&   #####SS######      x            WW################
##########   #######SS#####             x       ################
######&      ########S######                    ################
######&       #######S######                    #######     ####
#####WW   ss  ######    ####         XXX        #####& L     ###
#####WW ssss  ######    ####    x      X   x    B##&&     L  ###
######Wssss   #####BBBBBB####                   2##&   Q     ###
######WWWss  ######444444#####       x  x       2###         ###
##### WWWsss########3333#######                 2###         ###
##### #########################                 2####       B###
####  ##########################  WWWW      X  B#####   x  B####
###  ############################ WWWWWWW      #######      ####
###  ##############################WWWWWW    #########x    #####
#### sss#################222#BB#####W#################    ######
#####  sss##############2222# 5B5### ####x2#########4#    ######
######## s##############BBBB# ##5###&####&&#######BB4#   W######
######### ##############    # #####&&####&####### X 4#WWWW######
#########WWWW   ########   ## ##### #####&#######&& X#WWWW######
#########WWWW     #######s###S##### #####&######  & ##WWWW######
######## WWW       ######sSSSS####  #####&####  && ##      #####
#######12      x    #####s######## ######&###    ###       #####
#######12   L       #####s######   ###### W#    ##&    LL   ####
#######12            ####s#####     #####WW# ####  &&        ###
#######BB            ####ss####  x   ####W#  ####& & &        ##
#######          x   #####s####  X   ### WWW ####             ##
#######       x    & #####s####     WW#  #W #####      x      ##
#######            & #####s#####    W    #W ### #           L ##
#######              #####ss####   ##   ## ###         Q      ##
########           &#######s####S####   #  ###                ##
########          x #######ss###S#####  ##  #   #          &  ##
########         & #########SSSSS#####   ####  ###   X  X&& & ##
####           &&&###########SS######### sssss ####     &&& 2###
#     ####################################ss#########   2B2#####
#  ####################################################2########
################################################################
