################################################################
#  3   #                    #SW                       &&ssWWWW #
#      #                    ##Ws                    &  &&sWSSWS#
#  x   #                     #ss               &&          WW###
#     W#                     ##s            & &          #######
### ####                      ###                     ####     #
# # #                           ####     &       ######        #
# # #                              ####s# #s######             #
# # #                                 ### ###                  #
# # #                                 #s & s#                  #
# # #                                 #s & s#                  #
# # #                    ###############  &#########           #
# # #                    s#ss#ss#ss#ss#s   s#ss#ss#s           #
# # #                                                          #
# # #                                     &                    #
# # #                #s  s#ss#ss#ss#ss#s   s#ss#ss#s           #
# # #   ###############  ###############   #########           #
# # #####  #  #  #  ##s  sS     ##   1#s  &s#                  #
# #s###  x       X   #s  s##### ##   4#s & s#                  #
# #S#  3s  &         ##  ##   # #  x  ##   ##                  #
# #SS  5S #   #   #  s   s#   # # #####s   s#                  #
# #### 3sx      &   sW   s##### # #   #s &2s#                  #
#   ###       X      ##  ##       #   ##   ##                  #
#    ####  #  #  #  ##s  s#############s&  s#                  #
#       ##############s  s#############s&  s#                  #
#             #########  ####ss#ss#ss#ss   ##                  #
#             #SSsWsssWWWsWWss  &   &      s#                  #
###############WssWWsWSWWWsWS    s   x     s#                  #
#s#ss#ss#ss#ss#ss    WWWSWs&#ss#ss#ss#s    ##                  #
#W  2      &          WWSW  ###########    s#                  #
#           3WW   &  &&WW   #    s#s11     s#                  #
#s#ss#s  s#sss#     X   W   # x #s#s       ##                  #
#######  ######  S          #   # ##  SsS   #                  #
#    #s  s#  #             1##### #s  s#s                      #
#    #s  s# ##  x     WW  11#   # #s4 s#s                      #
#######  ## #W      WWsW  12#   # #######                      #
#s114#   s# #WW     W      s#   # ###4##s                      #
#33 2#s  s# ##WW          sW#####  SSW##s                      #
#   W##  ##  ##WWW   x    Ws##5sW###S####                      #
### ##s  s########WsWWssWWWs#sWSW  x ####                      #
#s  sss  sss#ss#W1sWWsSS3SSS#WS      W#S##                     #
#             WsssWsWWWW2SWW##   Ws    SW###                   #
#    x         WWsWsWW5WWWsssW  W WW  #Ss45#                   #
################################################################
