################################################################
#                                                              #
#                                                              #
#                                                              #
#                                                              #
#                                                              #
#                                                              #
#                                                              #
#                                                              #
#                                                              #
#                                                              #
#                                                              #
#                                                              #
#                                                              #
#                                                              #
# ##### #    # #   #  #   # ##### #      ###                   #
#   #   #    # ##  #  ##  # #     #     #                      #
#   #   #    # # # #  # # # ###   #      ###                   #
#   #   #    # #  ##  #  ## #     #         #                  #
#   #    ####  #   #  #   # ##### #####  ###                   #
#                                                              #
#                                                              #
#                                                              #
#                                                              #
#                                                              #
#                                                              #
#                                                              #
#                                                              #
#                                                              #
#                                                              #
#                                                              #
#                                                              #
#                                                              #
#                                                              #
#           ##### #   #  #  #####         #                    #
#           #      # #   #    #            #    # #            #
#           ###     #    #    #       #######                  #
#           #      # #   #    #            #    # #            #
#           ##### #   #  #    #           #                    #
#                                                              #
#                                                              #
#                                                              #
#                                                              #
################################################################
