################################################################
#5533  ##     ##        11 ##SW     33  111           &&ssWWWW #
#      ##    ##         11  ##Ws                    &  &&sWSSWS#
#  x   #######    #    #    ##ss       L       &&          WW###
#     W##                   ###s            & &          #######
### #####            Q      # ###                     ####     #
# # #  #s  s##    #    #    #   ####     &       ######        #
# # #  #s  s###             #      ####s# #s######             #
# # #  ##  ## ##      454  ##         ### ###                  #
# # #  #s  s#  ##############         #s & s#                  #
# # #  #s  s#  #                      #s & s#                  #
# # #  ##  #############################  &#####################
# # #  #s  #ss#ss#ss#ss#ss#ss#ss#ss#ss#s   s#ss#ss#ss#ss#sssWsS#
# # #  #s     x                                 x            WS#
# # #  ##                                 &               s   s#
# # #   ##ss#ss#ss#ss#s  s#ss#ss#ss#ss#s   s#ss#ss#ss#s   ss   #
# # #   ###############  ###############   ############  sWs   #
# # #####  #  #  #  ##s  sS     ##   1#s  &s#Ws#ss#ss#s  WsWS  #
# #s###  x       Q   #s  s##### ##   4#s & s#W           sSsW  #
# #S#  3s  &         ##  ##   # #  x  ##   ##s     &  X  ssW 11#
# #SS  5S #   #   #  s   s#   # # #####s   s####          s  11#
# #### 3sx      &   sW   s##### # #   #s &2s#s      S        11#
#   ###       X      ##  ##       #   ##   ##s    4SSS    Q    #
#    ####  #  #  #  ##s  s#############s&  s##    SW4S        ##
#       ##############s  s#############s&  s#s    S5SW   S    ##
#             #########  ####ss#ss#ss#ss   ##s    SWWS       ###
#             #SSsWsssWWWsWWss  & & &&     s##    SSWW    x  # #
###############WssWWsWSWWWsWS&   s   x     s#s     SW   &3   # #
#s#ss#ss#ss#ss#ss    WWWSWs&#ss#ss#ss#s    ##s     SS   3   ## #
#W  2      &          WWSW  ###########    s##         ss   #  #
#           3WW   &  &&WW   #11  s#s11     s#s         s    #  #
#s#ss#s  s#sss#     X   W   #1x #s#s       ##s   X         ##  #
#######  ######  S          #122# ##  SsS   ##   ##       ##   #
#    #s  s#  #             1##### #s  s#s   ##   ### xx  ##    #
#    #s  s# ##  x     WW  11#   # #s4 s#s        ###############
#######  ## #W      WWsW  12#   # ########      ##             #
#s114#   s# #WW     W      s#   # ###4##s##1121##              #
#33 2#s  s# ##WW          sW#####  SSW##s ######               #
#   W##  ##  ##WWW   x    Ws##5sW###S####                      #
### ##s  s########WsWWssWWWs#sWSW  x ####                      #
#s  sss  sss#ss#W1sWWsSS3SSS#WS      W#S##                     #
#             WsssWsWWWW2SWW##   Ws    SW###                   #
#              WWsWsWW5WWWsssW  W WW  #Ss45#                   #
################################################################
