###############################################################################
#      #                                                                      #
#      #                  #                                                   #
#      #                  #                                                   #
#   ####                  #                                                   #
#                         #                                                   #
#                         #                                                   #
#                         #                                                   #
##################################################################            #
#                                            #                                #
#                                         #  #                                #
#                                         #  #                                #
#                                         #  #                                #
#######################                   #  #                                #
#                     #                   ####                                #
#                     #                      #                                #
#                     #                      ######################           #
#                     #                                                       #
#                                                                             #
#                                                                             #
#                                                                             #
#                                                                             #
###############################################################################
