################################################################
#      #                                                       #
#      #                  #                                    #
#      #                  #                                    #
#   ####                  #                                    #
#                         #                                    #
#                         #                                    #
#                                                              #
#                                                              #
#                                                              #
#                  ######                                      #
#                    ####                                      #
#                  ######                                      #
#                                                              #
#                                                              #
#                                                              #
#                                                              #
#                                                              #
#                                                              #
#                                                              #
#                                                              #
#                                                              #
#                                                              #
#                                                              #
#                                                              #
#                                                              #
#                                                              #
#                                                              #
#                                                              #
#                                                              #
#                                                              #
#                                                              #
#                                                              #
#                                                              #
#                                                              #
#                                                              #
#                                                              #
#                                                              #
#                                                              #
#                                                              #
#                                                              #
#                                                              #
#                                                              #
################################################################
