################################################################
#       #                                                      #
#       #    ssssssssssssssss                                  #
#       #           ssssssssssssss                             #
#       #         sssssssssssss         #                      #
#       #           ssssssssssssssss    #                      #
#       #         ssssssssssssss        #                      #
#       #        ssssssssssssss         #                      #
#       #      sssssssssssssssss        #                      #
#####  ##     ssssssssssssssssss        #########              #
#          sssssssssssssssssss                                 #
#          WWWWWWWWWWssssssssssssssss                          #
#   SSSSSSSSSSSSSSSSSSSSS                                      #
#######  #### SSSSSSSSSSSSSSSSSS   ############                #
#           #                      #          #                #
#           #                      #          #                #
#           #                      #          #                #
#           #                                                  #
#           #                      #          #                #
#           #                      #          #                #
#           #                      #          #                #
#           #                      ############                #
#           #                                                  #
#                                                              #
#                                                              #
#                                                              #
#                                                              #
#                                                              #
#                                                              #
#                                                              #
#                                                              #
#   ###############################                            #
#                                                              #
#                                                              #
#                                                              #
#                                                              #
#                                                              #
#                                                              #
#                                                              #
#                                                              #
#                                                              #
#                                                              #
#                                                              #
################################################################
