###############################################################
#       #                                                     #
#       #                                                     #
#       #                                                     #
#       #                               #                     #
#       #                               #                     #
#       #                               #                     #
#       #                               #                     #
#       #                               #                     #
#####  ##                               #########             #
#                                                             #
#          WWWWWWWWWW                                         #
#   SSSSSSSSSSSSSSSSSSSSS                                     #
#######  #### SSSSSSSSSSSSSSSSSS   ############               #
#           #                      #          #               #
#           #                      #          #               #
#           #                      #          #               #
#           #                                                 #
#           #                      #          #               #
#           #                      #          #               #
#           #                      #          #               #
#           #                      ############               #
#           #                                                 #
#                                                             #
#                                                             #
#                                                             #
#                                                             #
#                                                             #
#                                                             #
#                                                             #
#                                                             #
#   ###############################                           #
#                                                             #
#                                                             #
#                                                             #
#                                                             #
#                                                             #
#                                                             #
#                                                             #
#                                                             #
#                                                             #
#                                                             #
#                                                             #
###############################################################
