###############################################################
# #   #   #   #   #   #   #   #   #   #   #                   #
#   #   #   #   # # #   #   #   #   # # # #                   #
################# ############### # ### # #                   #
#               # #  # #          #     # #                   #
#            ## #    # # ################ #                   #
#             # # #  #   #                #                   #
#             # # #  # # ######## #########                   #
#             # # #    #       #                              #
#             # # ########  ####                              #
#             #                                               #
###############################################################
#                                                             #
#                                                             #
#                                                             #
#                                                             #
#                                                             #
#                                                             #
#                                                             #
#                                                             #
#                                                             #
#                                                             #
#                                                             #
#                                                             #
#                                                             #
#                                                             #
#                                                             #
#                                                             #
#                                                             #
#                                                             #
#                                                             #
#                                                             #
#                                                             #
#                                                             #
#                                                             #
#                                                             #
#                                                             #
#                                                             #
#                                                             #
#                                                             #
#                                                             #
#                                                             #
#                                                             #
###############################################################
