################################################################
# #   #   #   #   #   #   #   #   #   #   #                    #
#   #   #   #   # # #   #   #   #   # # # #                    #
################# ############### # ### # #        #           #
#               # #  # #          #     # #         #          #
#            ## #    # # ################ #          #         #
#             # # #  #   #                #           #        #
#             # # #  # # ######## #########           #        #
#             # # #    #       #                       #       #
#             # # ########  ####                        #      #
#             #                                         #      #
########################################################## #####
#                                                        #     #
#                                  #                      #    #
#                                 #                       #    #
####################             #                       #     #
#                 #             #                        #     #
#                 #            #                        #      #
#                 #           #                         #      #
#                 #          #                                 #
#                 #         #                                  #
#                          #                                   #
#                         #                                    #
#                        #                                     #
#                       #                                      #
#                      #                                       #
#                      # #                                     #
#                    #                                         #
#                    #                                         #
#                    #                                         #
#                     #                                        #
#                     #                                        #
#                     #                                        #
#                     #                                        #
#                     #                                        #
#                     #                                        #
#                      #                                       #
#      #########################################################
#                          #                                   #
#                     #    #                                   #
#                     #    #      ########################## ###
#                     #    #      #                            #
#                     #           #                            #
################################################################
