################################################################
#  sssssssssssSSSSSSSSSSSSSssssSWWWsssWWWWssWWWWWWWWWWWWWsWssWS#
#  ssssWWWWWSSSSWWSSssssWSSsSSssWWssSSWWWSWSWSsssWWSssssssssssW#
#          s  WWS S   W W   s                        W    s    #
#   S SW   ss s WW    W  W ss s s s s            s    W  s W   #
#      SWSSs s W W  S W    s WW       ss s s s  W   s W   W WW #
#S S S     SW S    S  W   WSS      WS S       s   s  S  WS s   #
#   S S   s  s     WSWS      SS   W    S       s   s  S  S     #
#W     Sss    s        SW s 1212W       SWS     s  s   W S s   #
# W  W  sS BBB  WWWWWWWWWWWWWWWWWW            s         W S S  #
#  s W         s  s        s         21122    s  s s    Ws     #
#  s  WWW   S   s  s WWWWW        WWWWWW      s W   s          #
#  s     sWS  S  s s      W   Ws   SSS        s W    s s       #
# sss s   s S   S SssssWWssWWWWWWSSSSSSSss    sW  W     s      #
#s s  s    s S    Ss  s s   S s      S        sW    W    W     #
#ss   s  sW s SW  S    ss sS   ss    S    11  sW      W        #
#  s  s W  WSWS    S   ssS  s   ss   S     33 sW        WW     #
#  WWWWWWWWWWWWWWWW S  sSS S  s    S  S   BBB  W  S     WW     #
#   W   W  S          S    S        s  S S S s WSS S s sW  s   #
#   W   W   S  S 2222   S    s               WS  s S S  W  s   #
#    WWW  s    WS SSSSssSSSSSSSSSSSSSSSSSs  S ss sss S s       #
#  sSW  W ss   WWW SWSWSWSWSWSWSWSWSWSWSWSWSWSSWSWSWSW s       #
#  sSWSWS s  s W S          Ss    WWWWWWSWWWWWWWWWWWWWWs   s   #
#  sSWSWWs BB  W         s    S    1212 S             s   s    #
#   SWSs s    sW  S    WWWW ssssSs s s   s  s    s    s  s  S  #
#  sS s       s W   S      WW sWW S      S   s ss  s  s   WSS  #
# B           s       S S     s     S   s S  s s    s  s       #
#  sSssSSWWW  s W         S      WW  S    W ss        ssss SW  #
# B       W 1111 WWWWWWWWW S  ss   s    s W ss       s  ss   WS#
# B      SSWSSSSWSSSSSSSSSS S       WW SWWW ss        ssss     #
#    W          WWWWWWWWWWssSSsSSSSSSSSSSSSSSSS S     s ss S   #
#     ssS     W SWWW sS  SS   sss s       S  s  SW    s  ss    #
#   W SssWWsW   SWssS   S   s sssS  sS      S s s SW s  W sWWS #
#   W W W      SsWsS    S     ss s    S    S  S s ss W S  s    #
#    W     W   SSsS     S  SSs s s ss   SS S    Ss s   W    SW #
#     W   W    SsssSSSSSSsSSSSSsSs  sS            ss   S  s    #
#      W W    s Ss     sSs s         sSSS  W SWSS   S S        #
#s       BB      s SSSS  s  s  ss    WSS WS      W S W    SSSSS#
#  s 2121s s s   s  s W sSs   ss sSSW   SS S   ssssssssssss    #
#      s       SSSS  s sS    s  sWSs SSWSW  S        S         #
#  WWWWWssWssSSWWSSWss sS s     ss   s       S        S        #
#  ssSSsSSSssSS  SSSs SSS  ss sss     WWWWWWWWWWWWWWWW  S      #
#    s      s sSSSSSS s      ssWSSSWSWS   SSSWWSSWWSSWSW       #
#   SWSWSSSSSSWSWSSSSSSSSSSSWSWSWSWSWWWWSWSW                   #
################################################################
